###########################################
#                                         #
#                                         #
#                                         #
#           .         .     .             #
#                                         #
#                                         #
#            .       .       .            #
#                                         #
#                                         #
#                                         #
#                                         #
###########################################